11111111111111111111111111111111111
1....1..1..........1...1....M...111
1.P..1..1....M..11..1...........111
1..........11......11.....1.....111
1.M....M....11111111....1111.111111
11111..................1....1...111
1.......1..............1...1.......
1......................1..1.....111
111111......111111111111........111
1.............1.................111
1.....1.......1.....M.....1111..111
1.....1.......1.........11......111
1.....1.......1.....1111........111
1.....1.......1...11.......11111111
1....11111..111111...M....1..1..111
1....1.......1..........11......111
1....1.......1......1111......1.111
1....1...M...1...111.....1.....1111
1....1.......1...1...11111..1...111
1....1.......1......1....11111..111
111111....11111....1..111.......111
1........1....1..111......111111111
1.......1.....1111....111.....1.111
1......1......1..1........M...1.111
1..1111...M...1111..1.1.........111
1.....1.......1..1..1.1.........111
1.....1...11...1.1111..11111111.111
1..........1...............1....111
11111111111111111111111111111111111